...###
..##.#.####
.##..###..#
##..s...c.#
#..@...#..#
###..###..#
..#..#....#
.##.##.#.##