...###
..##.#.####
.##..###..#
##..s...c.#
#......#.p#
###.@###..#
..#..#....#
.##.##.#.##