...###
..##.#.####
.##..###..#
##..s...c.#
#......#.p#
###@.###..#
..#..#....#
.##.##.#.##