...###
..##.#.####
.##..###..#
##..s@..c.#
#......#.p#
###..###..#
..#..#....#
.##.##.#.##